10
# # # # # # # # # #
. . # . # . . . . #
# . # . . . # # # #
# . # . # . # . # #
# . # . # . # . # #
# . # . # . # . # #
# . . . # . . . . #
# . # . # . # . # #
# . # . # . # . # #
# # # # # # # . # #
